10
W.S.-.B.P.B.-.-.-.-
S.G.S.B.P.B.-.-.BG.-
-.BS.W.BS.P.B.-.B.P.B
B.P.BS.-.B.-.-.-.B.-
P.B.-.-.-.-.-.-.-.-
B.S.-.-.G.-.B.-.-.G
S.W.S.-.-.B.P.B.-.-
-.S.-.-.-.-.B.G.B.-
-.-.-.G.-.-.-.B.P.B
A.-.-.-.-.-.-.-.B.-