10
-.-.-.-.-.-.-.-.-.-
-.-.-.-.-.-.S.B.-.-
-.-.-.-.-.S.WB.PS.B.-
-.-.-.-.-.-.S.B.-.G
S.-.-.B.-.-.-.-.-.-
W.S.B.P.B.-.-.-.-.-
S.G.-.B.-.-.-.-.-.-
-.-.-.-.-.-.-.-.B.-
-.-.-.-.-.-.-.B.P.GB
A.-.-.-.-.-.-.-.B.-
